
###XXXX#XXX###////\///\////!///#################################
##---------------/////////\-/\/#################################
##A---####--##///-\//\//\/----\#################################
##-------#--##/\\/-//--/\-\//\P#################################
##############/////--\/--//\///#################################
///\\///\/\\///\//\//////////\/#################################
################################################################
################################################################
################################################################
################################################################
################################################################
################################################################
################################################################
################################################################
################################################################
################################################################
################################################################
################################################################
################################################################
################################################################
################################################################
################################################################
################################################################