[PF]
----------àHT66-;K-XXXXXXXXXXXXXXXXXXXXXXXXXXXXXX)-- 66111ñ111--
-66666666666666-66))))))))))))))))))))))))))))))))66 6611111116-
----------66----662222222222222222222222222222222266 6611111116‘
66ààààà66-66-66-66((((((((((((((((((((((((((((((((66 66666-6666-
661111166-66”66--(22222222222222222222222222222222--       YY®6<
666666666-66-666666666666666666666666666666666666666 66666-66666
----•--------66666>;S---622222222222222222222222662YWY2666-66666
I6666666666666666666666-6@@@@@@@@@@@@@@@@@@@@@@@662YPY266W6666//
O:OO:::O:OO:66’-—-’66K@@@@                      662YWY26W666///\
:O::O:O:O::O66-LLL-666666@@@@@@@@@@@@@@@@@@@@   6666 666666//\"\
:::::O::::O:66DDDDD6666662222222222222222222@        66666//\\\\
:OOO::::O::O66DDDDD6666666666666666666666666666666666666///\\\\\
O:::O:OO:O:O664444466666666666666666666666666666---6666///\\\U\\
:O[66O66::O:6666666-1-1-1-1-1-1-1-1-1-1-1-1-1-1--U-666///\\\\\\\
RRRR6-6RRRRRRR6666666666666666666666666666666666---66////\\\\\\\
RRRR6-6RRRRRRRRRRRRRRRRRRRRRRRRRQX.X.X.X.X.X.X.X6666////\\\\\\\\
?]]66-66]]RRRRRRRRRRRRRRRRRRRRRRRRRRRRRRRRRRRRRRRRRRRRRRRR66-66\
-------------------$$$$$$$$•RRRRRRRRRRRRRRRRRRRRRRRRRRRRRRR6-6RR
$$$$$$$$$$$$$$$$$$$$$$$$$$$$$$$$$$$$$$$$$$$$$$$$$$$$$•RRRRR6-6RR
WWWWWWWWWW$$$$$$$$$$$$$$$$$$$$$$$$$$$$$$$$$$$$$$$$$$$$$$$$66-66+
MMMMMMMMMMMMMMMMMMMMMMMMMMMMMMMMMMMMMMMMMMMMMMMMMMMMMMMMMMMMMMMM
MMMMMMMMMMMMMMMMMMMMMMMMMMMMMMMMMMMMMMMMMMMMMMMMMMMMMMMMMMMMMMMM
KMMMMMMMMMMMMMMMMMMMMMMMMMMMMMMM|MMMMMMMMMMMMMMMMMMMMMMMMMMMMMMM
