[PF]
VVVV--P-VVVVVVVVVVVVVVVVVVVVVVVVVVVVVVVVVVVVVVVVVVVVVVVVVVVVVVVV
VVVV----VVVVVVVVVVVVVVVVVVVVVVVVVVVVVVVVVVVVVVVVVVVVVVVVVVVVVVVV
VVVV----VVVVVVVVVVVVVVVVVVVVVVVVVVVVVVVVVVVVVVVVVVVVVVVVVVVVVVVV
VVVV----VVVVVVVVVVVVVVVVVVVVVVVVVVVVV-----------------------VVVV
VVVV---------------VVVVVVVVVVVVVVVVVV-----------------------VVVV
VVVV---------------VVVVVVVVVVVVVVVVVV----VVVVVVVVVVVVVVV----VVVV
VVVVVVVVVVVVVVV----VVVVVVWWVVVVVVVVVV----VVVVVVVVVVVVVVV----VVVV
VVVVVVVVVVVVVVV----VVVVVVWWVVVVVVVVVV----VVVVVVVVVVVVV?V----VVVV
VVVVVVVVVVVVVVV----VVVVVVWWVVVVVVVVVV----VVVVVLLVVVVVVVV----VVVV
VVVVVVVVVVVVV]V----VVVVVVWWVVVVVVVVVV----VVVVV--VVVVVVVV----VVVV
VVVVVVVVVVVVVVV----VVVVVVWWVVVVVVVVVV----VVVVV--VVVVVVVV----VVVV
VVVVVVVVVVVVVVV----VVVVVVWWVVVVVVVVVV----VVVVV--VVVVVVVV----VVVV
VVVVVVVV-----------VVVVVVWWVVVVVVVVVV----VVVVV--VVVVVVVV----VVVV
VVVVVVVV-----------VVVVVVWWVVVVVVVV]V----VVVVV--VVVVVVVV----VVVV
VVVVVVVV----VVVVVVVVVVVVV++VVVVVVVVVV----VVVV----VVVVVVV----VVVV
VVVVVVVV----VVVVVVVVVVVVV++VVVVVVVVVV----VVVV----VVVVVVV----VVVV
VVVVVVVV----VVVVVVVVVVVVV++VVVVVVVVVV----VVVV----VVVVVVV----VVVV
VVVVVVVV---------------------------------VVVV----VVVVVVV----VVVV
VVVVVVVV---------------------------------VVVV----VVVVVVV----VVVV
VVVVVVVVVVVVVVVVVVVVVVVVVVVVVVVVVVVVVVVVVVVVV----VVVVVVV----VVVV
VVVVVVVVVVVVVVVVVVVVVVVVVVVVVVVVVVVVVVVVVVVVV---------------VVVV
VVVVVVVVVVVVVVVVVVVVVVVVVVVVVVVVVVVVVVVVVVVVV---------------VVVV
VVVVVVVVVVVVVVVVVVVVVVVVVVVVVVVVVVVVVVVVVVVVVVVVVVVVVVVVVVVVVVVV

[ST]
##LavaRate 15
Press any key to begin this level.