###key#shop###MTMMMMMMMMMMMMMMMMMMMMM-----MMMMMMMMMMMM-MM--!##LL
##Káà44@@@@@##MMMMMMMMMMMMMMMMMMMMMM-MMMMM-MMMMMMMMMM-M-M-P-##LL
##Ká3##@@@@@@DMMMMMMCMMMMMMMMMMMMMM-MMMMMMM-MMM<MMMM-MMM----##DD
##Káà##@@@@@##M-MMMMMMMMMMMMMMMM---MMMMMMMM-MMMMMMM-MMMMMMMM##DD
#######X######MM-MMMMMMMMMMM----MMMMMMMMMMMM-MMMMM-MMMMMMMMM##DD
##ñ-----##MMMMMMM-MMMMM-----MMMMMMMMMMMKMMMMM-MMM-MMMMMMMMMM##DD
##########MMMMMMTMMMMM-MMMMMMMMMMMMMMMMMMMMMMM-M-MMMMMMMMMMMMMMM
MMMMMMMMMMMMMMMMMMMMM-MMMMMMMMMMMMMMMMMMMMMMMMM-MMMMMMCMMMMMM-MM
MMMMMMMM-----MMMM----MMMMMMMM[MMMMMMMMMMMMMMMMMMMMMMMMMMMMMM-MMM
MMMM----MMMMM----MMMMMMMMMMMMMMMMMMMMMMMMMMMMMMTMMMMMMMMMMM-MMMM
MMM-MMMMMMMMMMMMMMMMMMMMMMMMMMMMMMMMMMMMMMMMMMMMMMMMMMMMMMMM-MMM
MM-MMMMMMMMMMMMMMMMMMMMMMMMMMMMMMMMMMMMMMMMMMMMMMMMMMMMMMMMMM-MM
MM-MMMMMMCMMMMMMMMMMMMMMMBWWWWWWWWWW-------------------------MMM
MM-MMMMMMMMMMMMMMMMMMMMMMMMMMMMMMMMMMMMMMMMMMMMMMMMMMMMMMMMMM-MM
MM-MMMMMMMMMMMMMMMMMMMMMMMMMMMMMMMMMMMMMMMMMMMTMMMMMMMMMMMMMMM-M
MMM-------MMMMMMMMMMMMMMMMMMMMMMMMMMMMMMMMMMMMMMMMMMMMMMMMMMM-MM
MMMMMMMMMM-----MMMMMMMMMMMMMMMM]MMMMMMMMM-M-MMMMMMMMMMMMMMMM-MMM
)))))))))MMMMMM-MMMMMMMMMMMMMMMMMMMMMM-M-M-M-MMMMMMMMCMMMMM-MMMM
22222222)MMTMMM-MMMMMCMMMMMMMMMMMMMMM-M-MMMMM-MMM-MMMMMMMM-MMMMM
22222222)MMMMMM-MMMMMMMMMMMMMMM------MMMMMMM-MMM-M-MMMMMM-MMMMMM
22222222)MMMMMM-MMMMMMMMMM-----MMMMMMMMMMMM-MMM-MM-MMMMM-MMMMMMM
--222222)MMMMMM-----------MMMMMMMMMMMMMMMM-MM-M-MMM-M-M-MMMMM"MM
K-222222)MMMMMMMMMMMMMMMMMMMMMMMMMM|MMMMMMM--M-MMMMM-M-MMMMMMMMM