66666666666666666666----------------------------66WW---I-------K
-----------D D D-----66666666666666666666666666(6666666666666---
-666666666666666666-((((((((((((((((22222222222(-----------666-6
-666666666666666666-66((((((((((((((22222222222(6-66666666-----6
-66666666666066WYY6-66VVVVVVVVVVVVVVVVVVVVVVVVV66-66666666666666
------------0B6WYY--66T-W-W-*-W-W-C-W-W-*-W-W-T66-66666666663666
-66666666666066WYY6666666666666666666666666666666’66666666636666
-MMMMM6666666666666666666666666666666666666666666-66666666366666
-MMMMM............................3!66222222266----$$$$$$$666666
-MMMMM6666666666666666666666666666666622222266~~~~~~~~~~~~-66666
-MMMMM666666666666666666666666666666662222266------------~~-6666
-MMMMM............................3H66222266-~~~~~~~~~~~~-~~-666
-MMMMM6666666666666666666666666666666622266-~~----------~~-~~-66
-66666666666666666666666666666666666@@@@66-~~-~~~~~~~~~~-~~-~~-6
----666-OWOWOWOWOWOWOWOWOWO 66666666@66@666-~~-~~K’-----~~-~~-66
-66-666-6666666666666666666 66666666@66-6666-~~-~~~~~~~~~-~~-666
-66F666-666T-3)K)3-T66           666@66-66666-~~---------~~-666C
-66F666-666T-3)))3-T66     G     666-66-666666-~~~~~~~~~~~-6666-
-66666---666666-666666           666-66-6633666-----------666333
-66YYYYYYYYY666-66666666666-66666666-66-66--6666666666666-666-66
--     P    666-66+------66-66-------66----Y--D-D-D-LL 66-666-66
666---------666-66666666-66-66Y66666-66666666666666666666-666-66
666222222222666-------------66---Z66--------------------------66