     U--2--U--2--U--2--U--2--U--55-====-===--=====-===--==--=--=
 #######-#####-#####-#####-#######=-==-=-=-==--==-=-=-==--==-==-
 ######-B-###-B-###-B-###-B-######==--===-=====--===W==========-
 ########chamber#of#horror########======================-------=
 ##22222222222222222222222222##ó##=---=-=-=-==--==--=---========
 ##22222222222222222222222222222##-===-=-=-=--==-=-=-=====-----=
 ##22222222222222222222222########=-============-=-===----=====-
 ##2222222222222222222222266"0LL##-==-=-=-W-====-==---======---=
 ####-############################=--=-=-===-===-========---====
      ##---##ãOOOOOOOOO33333333!##=========-====-====----===-===
########---##H####################==----====-====-”--========--ò
<F  22##111##ãã333333##3333333-[##=-====-==-============--======
FF  22##âââ##ãã333333##3333333--##-===-==-==------=====-==-=--==
    22##YYY##ãã333333##333333333##-==-=-==-=======-===-====-==-=
 P  22##ááá##ã#########444444444##=--==-==W======-===-========-=
    22##111##        ##         ##=====-===------===-==---=-===-
    22##ààà######### ##   ##‘   ##=--==-============-=-===-=---=
    22##             ##   ‘##   ##-==W==-=====---===-==--=======
    22##   ~~~~~  ## ##   ##–   ##=-==-==-===-===--==-===W=----=
    22##   ~~%~~  ## ##   •##   ##==-==-==---==-===--==-==-====-
    22##   ~~0~~  ## ##   ##‘   ##===-=-======-=--====-=-=====-=
    22##ô  ~~0~~  ## ##   ‘##   ##=-=-==-=-==-==-=--==-=-==-===-
      77ô  ~~     ##      ##“   44-=-====-=--==|====--===--=---=
