##################RRRRRRRRRRR#the#swamp#RRRRRRR-\\ü\\\\/\\\\\\\C
LL–D‘D“D--VVVV--44----------------------------RR-\\\\\\\\\\\\\\\
LL‘D”D‘D--VVVV--44--RRRRRRRRRRRRRRRRRRRRRRRR--RRR-/\\\\\\\\\U\\\
##################RRRR-------------------------RRR-\\\\/\\\\\\\\
RRRRRRRRRRRRRRRRRRRRRR--RRRRRRRRRRRRRRRRRRRRK))RRRR--\\\\\\\\\\\
R-----RRR-------R----)))RR)))))))3)3)3)3)3)3)3)3)3RRR--\\\\\\\\\
R-RRR“RR-RRRRRRR-RRR-RRRRRRRRRRRRRRRRRRRRRRRRRRRRRRRRRR--/\\\/\ü
R-RR-RR-RRR\\\RRR-RRR--------------------------•-------RR--\\\\\
R-RRRR-RR\\\K\\RRR-RR-RRRRRRRRRRRRRRRRRRRRRRRRRRRRRRRRRRRRR--\\\
R-RRR-RRRR\\\\\\RRR-RR------------Z-8’-999999999999ö--RRRRRRR--\
R-RR-RRRR\\\\\\ü\RR-RRR-RRRRRRRRRRRRR8-111111111111RRR-----RRRR-
R---RRRRRR-\\\RRRR-RRRRRFRRRRRRRRRRRRRRRRRRRRRRRRRRRRRRRRRR-RRRR
RRRR-RRRRR-RRRRRR-RRRS(((((+((((((((((((((((((K++(3RRRRRRRRR-RRR
RRRRR-RRRRããRRRR-RRRRRRRRRRRRRRRRRRRRRRRRRRRRRRRRRRRR*R.R*RRR-RR
RRRRRRTRRR1R-RR-RRR@@@@@@@RRRRRRRRRRRRRRRRRR-----------’-óRRRñRR
###RRRRRR11RR--RRRR@@RRRRFRR-66----H----------RRRRRRR*R.R*RRRRRR
77###RRR111RR--RR*F@@@22@WRR-RR-RRORRRRRRRRRRRRRRRRRRRRRRRRRRR  
7777###RR11RR--RR*F@@@22@WRR-RR-RRORR                          P
77777###RR1RR--RR*F@@@22@WRR-RR-RRORR  RRRRRRRRR-RRRRRRRRRRRRR  
77!777###RRRR--RR*F@@@22@WRR-RR-RR>RRFSRRRRRRRRRàRRRRRRRRRRRRRRR
7777777##RRRR--RR*F@@@22@WRR-RR-RRRRRàààààààààà3333333333Càààààà
77777777##RRR--RRRRFFRRRRRRR-RR-RRRRRRRRRRRRRRRRRRRRRRRRRRRRRR--
U7777777##RRR----------------RR---------------------------------