XXXXXXXXXXXXXXXXXXX#XXXXXXXXXXXXXXXXXXXXXXXX#XXXXXXXXX### P ###X
XXXXX##XXXXXXXXXXXXXXXXXXX##XXXXXXXXXXXXXXXXXXXXXXXXXXXX##  ##XX
XXXXXXXXXXXXXXX&-XXXXXXXXXXXXXXXXXX#XXXXXXXXXXXXXXXX#XXXXX#  #XX
#XXXXXXXXXXXXXXXX-XXXX--XXXXXXXXXXXXXXXX##XXXXXXXXXXXXXXXX  XXXX
XXXXXXXXX#XXXXXXXX-XX-XX-XXXXXXX#XXXXXXXXXXXXXXXXXXXXX##   #XXXX
XXX#XXXXXXXXXXX#XXX--XX#X--XXXXXXXXX#XXXXX#XXXX##XXXX##  ##XXXXX
XXXXXXXXXXXXXXXXXXXXXXXXXXX--XXXXXXXXXXXXXXXXXXXXXXX##XX##XXXXXX
XXXXXXXXXXX##XXXXXXXXXXXXX#XX-XXXXXXXXXXXXXXXXXXXXX##  ##XXXX##X
XXXXX#XXXXXXXXXXXX#XXXXXXXXXXX--XXXX##XXXXXX#XXXXX##  ##XXXXXXXX
XXXXXXXXXXXXXXXXXXXXXXXX#XXXXXXX-#XXXXXXXXXXXXX      XXXX#XXXXXX
XXXXX##XXXXXX#XXXXXXX#XXXXXXXXXX#X##XXXXX       XXXXXXXXXXXXXXXX
XXXXXXXXXXXXXXXXXXXXXXXXXXXX##XXX#   0    XXXXXXXX!XXXXXXXXXXXXX
XXXXXXXXXXXXXX#XXXXXXX===XXXXXXX#  XXXXXXXXXXXXXXXXXXXXXXXXXXXXX
XXXXXXX#XXXXXXXXXXXX=======XXXXX  XXXXXXXX#XXXXX#XXXXXXXXXX##XXX
XXXXXXXXXXXXXXXXX=========       XX=====XXXXXXXXXXXXX#XXXXXXXXXX
XX#XXXXXXX##XXX==========  ===========XXXXXXXXXXXXXXXXX#XXXXXXXX
XXXXXXXXXXXXXX==========  ===========XXXXXXXXX##XXXXXXXXXXXXXXXX
XXXX#XXXXXXX             ===========XX#XXXXXXXXXXXXXXXXXXXXX#XXX
XXXXXXXX    XX#XXXX================XXXXXXXX#XXXXXX#XXXXXXXXXXXXX
XXX     XX#XXXXXXXXXX===========XXXXXXXXXXXXXXXXXXXX##the#secret
XXXXXXXXXXXXXXXXXX#XXXXXX=====XXXXXXXXXX#XXXXXXXXXXX#tunnel#into
X  XX#XXXXXX##XXXXXXXXXXXXXXXXXX#XXXXXXXXXXXXXXXXXXX#the#kingdom
LLXXXXXX#XXXXXXXXXXXXX#XXXXXXXXXXXXXX#4XXXXXX##XXXXX#####of#kroz