   00000000000000’-Y-----000000000-0-0000000000000000000000-0000
 P 0000000000000--000-00-000000000-0-----K000000000-000-----0000
   000000000000-0-0000-0-00000000-0000000000000000-0000000000-00
0-000000000000000-00000-00000000000000000-000000-0000-0000W0--00
00000000000000000I000000-000!000000-0000000-0000--00-00000W00000
0-0000000000000000000000000YYY000000------0-0---0000000000W000-0
0--000000000000-0000000000---------000-0--0000000000000000W-000-
0000000000000000-00000000000000000-00000000000000000000000-00000
000--0000000000000-000-0-000000000000000000000000000000000000-00
00000000000000000-00000-0000000000000000000-0-666666666000000-00
0-0000-00000000--000000000000000000000-0----00DDDóLL&6600000-000
--00000000000-00-0000000000000000000000-0000-0666666666000--0000
0-00000000000000’00000000-0000-0000-00000-0000-000000000000-0000
-000000000000000-0000000-0-0000-00-00000--00000000000000-0000000
0-00000000000000-0-0000000-00-00000000000000000000000000000000-0
00-00000000000000-0000-00000-000-000-0--000000000000000000-0-000
00000000000000000----0-00000T-000-000-000000000000-00000000-0000
000--0000000000000000000000000000000000000000000000--0000000-000
00-00-00000-000000000000000000000000000000000000--00000000000-00
0-00000000-000000000000-00000000000000000000000-00-00000000000--
-00000000-0-000000-00000-------------0++++++++++0000000000000000
000--00000000---0-0-0--000000000000000000000000000--0-0-0-0-0-00
---00---00000-00-000-000-00<0[0|0"0000000000000000-0-0-0-0-0-000