###<@@@@@@@@@@@@@@@@@@@@@@@@@#one#@@@@@@@@@@@@@@@@@@@@@@@@@FK###
Kö###@@@@@@@@@@@@@@@@@@@@@@@@@;!:@@@@@@@@@@@@@@@@@@@@@@@@@@###$[
öö((###@@@@@@@@@@@@@@@@@@@@@@@:::@@@@@@@@@@@@@@@@@@@@@@@@###$$$$
((((((###@@@@@@@@@@@@@@@@@@@@@@@@@@@@@@@@@@@@@@@@@@@@@@###$$$$$$
(((((((2###222222222222222222222222222222222222222222###2$$$$$$$
(((((((2((###@@@@@@@@@@@@@@@@@@@@@@@@@@@@@@@@@@@@@@###$$2$$$$$$$
(((((((2((((###@@@@@@@@@@@@@@@@@@@@@@@@@@@@@@@@@@###$$$$2$$$$$$$
(((((((2((((((###@@@@@@@@@@@@@@@@@@@@@@@@@@@@@@###$$$$$$2$$$$$$$
DD##(((2((((((((###@@@@@@@@@@@@@@@@@@@@@@@@@@###$$$$$$$$2$$$####
DD#f(((2(((((((((##############77##############$$$$$$$$$2$$$##CC
DD#o(((2((((((((ö##2------------------------2##ô$$$$$$$$2$$$t#àà
DD#u(((2((((((((ö----------F---P----S--------88ô$$$$$$$$2$$$w#MM
&&#r(((2((((((((ö##2------------------------2##ô$$$$$$$$2$$$o#MM
LL##(((2(((((((((##############99##############$$$$$$$$$2$$$##MM
####(((2((((((((###)))))))))))õõõõ)))))))))))###$$$$$$$$2$$$##àà
(((((((2((((((###))))))))))))))))))))))))))))))###$$$$$$2$$$$$$$
(((((((2((((###))))))))))))))))))))))))))))))))))###$$$$2$$$$$$$
(((((((2((###))))))))))))))))))))))))))))))))))))))###$$2$$$$$$$
(((((((2###))))))))))))))))))))))))))))))))))))))))))###2$$$$$$$
((((((###2222222222222222222222222222222222222222222222###$$$$$$
((((###))))))))))))))))))))))))))))))))))))))))))))))))))###$$ôô
"(###))))))))))))))))))))))))))))))))))))))))))))))))))))))###ôK
###Kõ)))))))))))))))))))))))#three#))))))))))))))))))))))))F|###