        1    1     1  1     1     1   1      1        1         
   ---#######   1        1     1          1      1#######---   1
   #        #1      1     1        1    1      1  #+ + + + #    
1  #   TT   #     1   1      1   1          1     # + + + +#1   
   #        #  1        1       1     1         1 #+ + + + #    
   ##########       1     1         1     1   1   ##########  1 
1   1       1     1    1      1         1       1      1       1
  1      1      1                         1       1     1    1  
   1    1   1      1   XXXXXXXXXXXXXXX     1   1     1        1 
      1      1   1     XXXXX  I  XXXXX   1      1   1    1      
1   1    1    1    1   XXXX+     +XXXX    1   1       1        1
 1      1  1    1      XXXX+  P  +XXXX   1      1      1    1   
    1     1  1     1   XXXX+     +XXXX     1      1  1    1    1
 1   1     1     1     XXXXX  S  XXXXX   1    1       1      1  
1      1 1    1        XXXXXXXXXXXXXXX      1   1       1     1 
  1     1  1      1                      1     1    1      1    
    1       1    1     1     1     1    1     1       1 1      1
1  ##########1    1   1    1    1     1      1   1########## 1  
 1 # W W W W# 1        1    1     1      1 1      #        #    
1  #W W W W #   1   1    1     1     1         1  #   LL   #  1 
   # W W W W#1       1    1        1   1     1    #        #    
1  ---#######    1     1    1 1     1     1     1 #######---    
        1    1     1            1  1     1     1        1      1