K++//33X33X33X33X33X33X33X33X+XFX+X33X33X33X33X33X33X33X333//++K
+B//333X33X33X33X33X33X33X33XSXPXSX33X33X33X33X33X33X33X3333//B+
+//3333XXXXXX==============VVVVDVVVV==============XXXXXX33333//+
//33==3333333D33X33X33X33/CVV.....VVC/33X33X33X33D3333333==333//
/33====3333//RRRRRRRRRRRRRRRRD#D#DRRRRRRRRRRRRRRRR//3333====333/
333====3333VCRRRCVVV2222222222#B#1111111111VVVCRRRCV3333====3333
3333==33333VVRRCVVV22222222222###11111111111VVVCRRVV33333==33333
333333333333VRRVVV2222###################1111VVVRRV3333333333333
3333333333333RRVV22222#s#///3//+//3///###11111VVRR33333333333333
3333333333333RRV222222#a#3/RRRRDRRRR/3#t#111111VRR33333333333333
\\33XXX333VVDRR2222222#c#//RRRVVVRRR//#e#1111111RRDVV333XXX333//
C\33XBX333V+KVD222B222#r#DDRRRVAVRRRDD#m#111B111DVK+V333XBX333/C
\\33XXX333V+KRR2222222#e#//RRRVVVRRR//#p#1111111RRK+V333XXX333//
3333333333VV+RRV222222#d#W/RRRRRRRRR/+#l#111111VRR+VV33333333333
33333333333VVRRVV22222###///W/DWD/+///#e#11111VVRRVV333333333333
333333333333VRRVVV2222#########D#########1111VVVRRV3333333333333
3333==3333333RRCVVV222222222\K#D#K\111111111VVVCRR3333333==33333
333====333333RRRCVVV22222222\K#D#K\11111111VVVCRRR333333====3333
/33====333333RRRRRRRRRRRRRRRRRRDRRRRRRRRRRRRRRRRRR333333====333/
//33==33333333333333333BXXXXXXXSXXXXXXXB33333333333333333==333//
+//33333333333333333333XXXXXXX+++XXXXXXX333333333333333333333//+
+B//333333333333333333XXXXXXX+++++XXXXXXX3333333333333333333//B+
K++//3333333333333333XXXXXXX+++++++XXXXXXX33333333333333333//++K