XXXXX+++XX  XXXXXXXX2#XXXXXXXXX3XXXXXXXXXX2XXX XWXXX#######XXXXX
XXXX+XXX+XXX XXXXX  X2#XXXXXXX# #XXXXXXX#2#XXXXXX X #+++++#XXXXX
XXXX+XXX+XXXX XXXX XX#2#XXXXXX#3#XXXXXX#2#XXX XWXXXX#++T++#XXXXX
XXXXX+++XXXXXXX    XXX#2#XXXXX# #XXXXX#2#XXXXXXXXX XD+W+W+#XXXXX
XXXXXXXXXXXXXXXXXXXXXXX#2#XXXX#3#XXXX#2#XXXXXXXX XXX#++T++#XXXXX
XXXXXXXXXXXXXXXXXXXXXXXX#2#XXX# #XXX#2#XXXXXXXXXXXXX#+++++#XXXXX
XXXXXXXXXXXXXXXXXXXXXXXXX#2#XX#3#XX#2#XXXXXXXXCXXXXX#######XXXXX
XXXWWWWWWWWWWXXXXXXXXXXXXX#2#X# #X#2#XXXXXXXXXXXXXXXXXXXXXXXXXXX
XXXXXXXXXXXXXXXXXXXXXXXXXXXX       XXXXXXXXXXXXXXXXXXXXXXXXXXXXX
XXXXXXXXXXXXXXXXXXXXXXXXXXX# XXXXX #XXXXXXXXXXXXXXXXXXXXXXXXXXXX
############################ XIIIX #############################
L1  +1   1   1   1   1   1   XIPIX  1   1   1   1   1    1+   1L
############################ XIIIX #############################
XXXXXXXXXXXXXXXXXXXXXXXXXXX# XXXXX #XXXXXXXXXXXXXXXXXXXXXXXXXXXX
XXXXXXXXXXXXXXXXXXXXXXXXXXXX       XXXXXXXXXXXXXXXXXXXXXXXXXXXXX
XXXXXXXXXXXX##########XXXXXX### ###X XXX   XXXXXXXX   +  XXXXXXX
XXXXXXXXXXXX##sm#was##XXXXXXXX#1#XXX XX XXX XXXX XX XXXXX XX XXX
XXXXXXXXXXXX###here###XXXXXXXX# #XX XX XX I XX+ X X + XXX#X X XX
XXXXXX XXXXX##########XXXXXXXX#1#XXX  XX XXXXX XX XXX XXX  XXX X
XXXXXXXXXXXXXXXXXXXXXXXXXQXXXX# #XXXXXXX+XXXX XX XXX  XXXXXXXXX 
XXXXXXXXXXXXX XXXXXXXXXXXXXXXX#1#XX      XX  XX XXXX XXX  XXXX X
LXXXXXXXXXXXXXXXXXXXXXXXXXXXXX# #XX XXXXXX XXXXX X  XXX XX XXXX 
 CCCCCXXXXXXXXXXXXXXXXXXXXXXXX#1#XXX   +  XXXXXX  XXXXC XXX    X